1111111111111111111111111111
1E0000000000000C00000C000001
1110010111100000101001000101
1110010010101011111001000111
1P0000000C00C111111001111101
1111111111111111111111111111
