11111111111111111111111111111111111111111111111
1P000000000000000100000010001111111111000000011
1000011100001111C100000000011111111111000000011
10000111011110001010000000000000000000101111111
10000111111111100000000011101111110000001000011
100000000000000000000000000000000C0000000000011
10001000000000000000000000000000000001110000011
10000000000000000000000000000110000000000000011
10000000000000000000000000000110000000000000001
10000000000000000000000000000110000000000000001
10000000000000100000000000010000001111110000001
11110010000000010101010010100000000000000000001
10000000110000000001100001100100110000001110001
11011000000111111000011111101111011011011111011
1101100000001111110000111111101111C000011111E01
11111000000011000000000000011011110000011111111
111110000000110C00000000C0011011000000011111111
1000000000C011000000000000011011000000000000001
11111111111111111111111111111111111111111111111
