111111111111111111111
10000000000C000000001
1000000C000000C000001
1000000C000C000000001
100000000000000000001
10000000C00000PE00001
111111111111111111111
