111111111111111111111111111111111111111111111111111111111111111111111111111111111111111111111111111111111111111111111111
1P0000000000000001000000100011111111110000000111111111111111111111111111111111111111111111111111111111111111111111111111
1000011100001111C1000000000111111111110000000111111111111111111111111111111111111111111111111111111111111111111111111111
100001110111100010100000000000000000001011111111111111111111111111111111111111111111111111111111111111111111111111111111
100001111111111000000000111011111100000010000111111111111111111111111111111111111111111111111111111111111111111111111111
100000000000000000000000000000000C00000000000111111111111111111111111111111111111111111111111111111111111111111111111111
100010000000000000000000000000000000011100000111111111111111111111111111111111111111111111111111111111111111111111111111
100000000000000000000000000001100000000000000111111111111111111111111111111111111111111111111111111111111111111111111111
100000000000000000000000000001100000000000000011111111111111111111111111111111111111111111111111111111111111111111111111
100000000000000000000000000001100000000000000011111111111111111111111111111111111111111111111111111111111111111111111111
100000000000001000000000000100000011111100000011111111111111111111111111111111111111111111111111111111111111111111111111
111100100000000101010100101000000000000000000011111111111111111111111111111111111111111111111111111111111111111111111111
100000001100000000011000011001001100000011100011111111111111111111111111111111111111111111111111111111111111111111111111
110110000001111110000111111011110110110111110111111111111111111111111111111111111111111111111111111111111111111111111111
1101100000001111110000111111101111C000011111E011111111111111111111111111111111111111111111111111111111111111111111111111
111110000000110000000000000110111100000111111111111111111111111111111111111111111111111111111111111111111111111111111111
111110000000110C00000000C00110110000000111111111111111111111111111111111111111111111111111111111111111111111111111111111
1000000000C0110000000000000110110000000000000011111111111111111111111111111111111111111111111111111111111111111111111111
111111111111111111111111111111111111111111111111111111111111111111111111111111111111111111111111111111111111111111111111
